1111111111111111111111111
1000000000001000000000001
1011110111101011110111101
1211110111101011110111121
1000000000000000000000001
1011110101111111010111101
1011110101111111010111101
1000000100001000010000001
1111110111101011110111111
     101         101     
11111101  11911  10111111
      0   14 61   0      
11111101  1   1  10111111
     101  15 71  101     
11111101  11111  10111111
10000001         10000001
10111101  11111  10111101
1200010000003000000100021
1111010101111111010101111
1000000100001000010000001
1011111111101011111111101
1010000000101010000000101
1000111110101010111110001
1010000000002000000000101
1111111111111111111111111