1111111111111111111
1  2   2   2   2  1
1 111 1 111 1 111 1
121 121     121 121
1 111 1 1 1 1 111 1
1     121 121     1
1 11111 1 1 11111 1
121 2         2 121
1 1 11111211111 1 1
1   2         2   1
1 11111 111 11111 1
1  2    111    2  1
1 111 1 111 1 111 1
1 1 1 1  2  1 1 1 1
1211121211121211121
1     1 1 1 1     1
1211111 111 1111121
1                 1
1111111111111111111